C 225,30,0
F 220,100,0

NO ./texturs/test.xpm
SO ./texturs/test.xpm
EA ./texturs/test.xpm
WE ./texturs/test.xpm




1111111111111111111111111
10000000001100000000001
1011000001110000000000011
1001000000000000000000001
111111111011000001110000000000001
100000000011000001110111111111111
11110111111111011100000010001
111101111111110111010111010001
110000001101010111000010010001
10000000000000001100010S000010010001
100000000000000011010110000001
1100000111010101011101100000111
11110111 11101011101111010001
11111111 1111111 111111 11111
11111111 11111111 111111101111
