C 21,1,148
F 6,171,0

NO ./texturs/kargin.xpm
SO ./texturs/flag.xpm
EA ./texturs/images_64x64.xpm
WE ./texturs/bordo.xpm




1111111111111111111111111
1000000000110000000001
101100000111000000S0000011
1001000000000000000000001
11111111101100000000000000000001
    100000000011000001110111111111111
1111011111111101 100000010001
1111011111111101 1010111010001
1100000011010101 1000010010001
1000000000000000 100010000010010001
1000000000000000 1010110000001
1100000111010101011101100000111
11110111 11101011101111010001
11111111 1111111 111111 11111
11111111 11111111 111111101111
