SO ./textures/bordo.xpm
EA ./textures/images_64x64.xpm
NO ./textures/kargin.xpm
WE ./textures/flag.xpm
DO ./textures/test.xpm

F 255,171,0
C 21,1,148

1111111111111111111111111111111111111111
1                                      1
1                                      1
1   1                                1 1
1   1                               1  1
1   1   1                          1   1
1   1   1                         1   1
1   1   1   1                    1   1
1   1   1   1                   1   1
1   1   1   1   1              1   1
1   1   1   1   1              1   1
1   1   1   1   1              1   1
1               D      N       1   1
1   1   1   1   1              1   1
1   1   1   1   1              1   1
1   1   1   1   1              1   1
1   1   1   1                   1   1
1   1   1   1                    1   1
1   1   1                         1   1
1   1   1                          1   1
1   1                                 1
1   1                                1
1                                     1
1                                      1
1111111111111111111111111111111111111111
